NO     ./textures/north_texture.png
SO ./textures/south_texture.png
WE   ./textures/west_texture.png
EA ./textures/east_texture.png

F 200, 200, 200
C 100, 100,100

11111
10001
100N1
11111