NO ./textures/north_texture.png
SO ./textures/south_texture.png
WE ./textures/west_texture.png
EA ./textures/east_texture.png

F 240,128,128
C 218,165,32

1111111111111111111
1000A00000000001111
100101111100F001111
10010B00C0000001111
1001000D000J0001111
100E111110110000011
1111111111111111111