NO ./textures/north_texture.png
SO ./textures/south_texture.png
WE ./textures/west_texture.png
EA ./textures/east_texture.png

111111111111111
100000000000001
101111111110101
100100000010001
111101110011101
100001000010001
101101011110101
100000000000S01
111111111111111