NO ./textures/north_texture.png
SO ./textures/south_texture.png
WE ./textures/west_texture.png
EA ./textures/east_texture.png

F 240,128,128
C 218,165,32

111111111111111
100000000000001
101111111110101
100100000010001
111101110011101
100001000010001
101101011110101
100000000000001
111111111111111