NO ./textures/north_texture.png
SO ./textures/south_texture.png
WE ./textures/west_texture.png
EA ./textures/east_texture.png

F 0,0,139
C 32,178,170

111111111111111111111111111111
1S0000000000000000000000000001
101001000000101001000000010101
101001001010001001000000010101
100000000000000000000000000001
111111111110000000111111111111