NO ./textures/north_texture.xpm
SO ./textures/south_texture.xpm
WE ./textures/west_texture.xpm
EA ./textures/east_texture.png

F 145,10,175
C 54,20,230

111111111111111111
111111011100S01111
101100000000001111
100100110110001001
100101111111001001
100100111110000001
100001011100000101
100011001000001111
111111111111111111