NO ./textures/north_texture.png
SO ./textures/south_texture.png
WE ./textures/west_texture.png
EA ./textures/east_texture.png

F 145,10,175
C 54,20,-40

1111111111111111111
1000000000000000001
1011111111111101101
1001000000000100101
1111011110111101101
1000010000100000001
1011010111101111101
10000000000000000E1
1111111111111111111