NO ./textures/north_texture.png
SO ./textures/south_texture.png
WE ./textures/west_texture.png
EA ./textures/east_texture.png

F 0,0,139
C 32,178,170

11111111111111111111111
11100000000000011100001
11110000000100100010001
11011100001100000010001
1E000000001100000100001
11111111000111001000001
11100000000001001000101
10000011000001001000111
11011100001111000000011
11000000000000001001111
11111111111111111111111