NO ./textures/north_texture.png
SO ./textures/south_texture.png
WE ./textures/west_texture.png
EA ./textures/east_texture.png

C 0,0,139
F 0,100,0

1111111111111111111111111
1000000000000000000000001
1011111110111111111111101
1001000010000000000000101
1111011110111110111110101
1000010000000010100000101
1011110111111010101111101
1000000000001010000000001
1011111111101010111111101
1000000000100010000000101
1111101110111110111100101
1000101000000000000100001
1010101011111111101010101
1000101000000000000100001
1011101010111111101011101
100000001N000000000000001
1111111111111111111111111
