NO ./textures/north_texture.png
SO ./textures/south_texture.png
WE ./textures/west_texture.png
EA ./textures/east_texture.png

F 0,0,139
C 32,178,170

1111111111111
1           1
1 111110111 1
1001000   101
111101 100101
100001 000101
1011010111101
100000 0000W1
1111111111111